%%%%%%%%%%%%%%%%%%%%%%%%%%%%%%%%%%%%%%%%%%%%%%%%%%
%%%%%%  %%%%%% %%%%%%%%%%%%%%%%% %%%%%%%%%%%%%%%%%
%%O  %     %   %     %   %O% %  O%     % % %   O.%
%% % %O% % %%% %%%%  %%% % % %O%%%%%O%%% % % %%%%%
%%  O    %     %       O %    O% % O %  O  %   % %
%%%% %%% %%% %O%%% % %%% %%%O% % %%% %%%%%O% %%% %
%  %O  % % % % O   % %O%O%OO   O  O  %  O O%     %
%% %O%%% % %%% %O%O% % %O%% %%%% %%%O%%%%% % %%%%%
%%O       O%O  %   %O%O        O  O  O      O    %
%%%% %%%%% % %%% %%%%% % %O%%%%% % %%% %%O %%%%%O%
%%O% %OO O % % %O%O%   %O% %.%  O%     % O     % %
%%O%O%O% %.%%% %%% %%% %%%%% %%% %O%%% % % %%%%%O%
%% O % % %  O    % %O% % % % %   %   % % %  O  % %
%% % %%%%% %%%O% % % %%% % % %%%%% % %%% % % %%%%%
%% %O% % % % OO    O   %.     O    %  O% % %   % %
%%%%%% %O%%% %%% %.%%  %%%%%%% % % %%% %%  %%    %
%% O     O  O  % % O %  O      % %   % % O %   % %
%% %%% %O% %O% % %%%O%%% % %%% % %%%%%%%%%O%O% %O%
%% %   % % % % % %     O %O% OO%O      % % % %   %
%%%%%%%%%% %%%%%%%%%%% % % %%% % %%%% %% % % % %%%
%%     %O O%      .    % % % %O%  O  %O O  % O  O%
%%%%%% %%%O%%% %%%%O % % %O% %O%   %%% % %%% % %%%
%%O      O %   %     % % %   % %O%   %O%O% O %   %
%%%%%% %%%%%%%   %%%%% %%% %%%%% % %%O%% %%% %%% %
%%   O %   % % % %O O  %     %   %O% O   % OO  % %
%% % % % %%% %%%%%%%O% % % %%%%%%%O%%% %%%%% %%%%%
%%OO %     % % %O  %O%O  % %O%O      % % OO OO   %
%%%%%% % % %   %%%O% %%%O%%% %%% % % % % %%% % % %
%%   % % % .   %   % %   % %  O O%O%O% % %O  % % %
%%%%O%%% % %%%O%%%O%%% % % %% %%O% % %%%%%%% %%% %
%%   OOO % % % %    OO % %O O    % %O O%   OO%   %
%%%% % %%%%% % %%O%%%%%%% O%%% % %%%%%O%%%O%%% % %
%%O%   %   O   O %O  %O   O% O   % O   % O O % % %
%%O %% % %%% %%%O%  %%%%%%  %% %%%%% % %%%%%O% %%%
%%       %  O%    OO  O  O %OO OO  % % O % % %OO %
%% %%% % %%% %%% %%% %  %% %% O%%%%  %O%%% %%% % %
%% %O% %   %  O% %O  %   % %     %   %O%  O OO % %
%%O% %%  % % %%%%%O%%%%% %O%   % %%% % %OO % %%%O%
%% %  O  %O%    O% %O      % %O%   % % % % % % O %
%% %%%%%O%%% %%%%% %%%%%%%  %%%% % %  %%%%%%O%%% %
%% % %O    OOO %O  O %   OO%  O% O % % O       % %
%%%% % % % %% %% %%%%%%%%% % %%% % % %P%.%%% %%% %
%%  O O% % % .       % %   %O    % %O  %O  %   % %
%% %%%%% %%% % %%% % % %%%%%%%%% %%% % % %%% %%% %
%% % % %OO % % % . % %OO %O      % OO%   %   % O %
%%%  % % % %%%%%O%O%%%%%O  % %%%O%%%O%   %  %%%%O%
%% O     %O  %OO %  O%     %.%   % %   % % O OO%O%
%% %%%%% %%%%%%%O% % %%%%% %%%%% % %%%%% %%%O% % %
%% %         % .O% % %     %O   O      % %   % % %
%%%%%%%%%%%%%%%%%%%%%%%%%%%%%%%%%%%%%%%%%%%%%%%%%%
