%%%%%%%%%%%%%%%%%%%%%%
% O%    .   % % .    %
%    %%%%%% % %%%%%% %
%%%%%%     P  %      %
%    % %%%%%% %% %%%%%
% %%%% %     .   %   %
%  .     %%% %%%   % %
%%%%%%%%%%    %%%%%% %
%. O   .   %%    .   %
%%%%%%%%%%%%%%%%%%%%%%