%%%%%%%%%%%%%%%%%%%%%%
% O%    .   %.% .    %
%    %%%%%% %.%%%%%% %
%%%%%%     P .%      %
%O   % %%%%%%O%% %%%%%
% %%%% %     .   %   %
%  .O    %%% %%%   % %
%%%%%%%%%%    %%%%%% %
%. O   .   %%    .   %
%%%%%%%%%%%%%%%%%%%%%%