%%%%%%%%%%%%%%%%%%%%%%%%%%%%%%
%         P                %
% %%%%%%%%%%%%%%%%%%%% %%% %
% %%       %        % %O% %
% %% %%%%% %%%%%%% % %% % %
% %% % % % %       %    % %
% %% % % % % %%%%%%% %% % %
%    % % %   %       %% % %
% %%%% % %%%%%% %%% %%% % %
% %    %        % %     % %
% % %O% %%%%%%%%% % %%%%% %
% %    %           %     %
%    %%%%%%%% .    %% %%%%% %
%%%%%%%     %     %% %O    %
%     O     %%%% %    %% % %
% %%%%%%    %    %%%% %% % %
%      %%%%%% %%%%%%%%  % %
%%%%%%                %% %
%.         %%%%%%%%%%%%%%%%
%%%%%%%%%%%%%%%%%%%%%%%%%%%%%%